22
12
1111111111111111111111
1111111111110000000111
1111111111110000000111
111111111111000E000111
1110000000000000000111
1110000000000000000111
1110000000000000000111
1110000001111111111111
1110000001111111111111
111000R001111111111111
1110000001111111111111
1111111111111111111111