25
14
But What If There Were Two
1111111111111111111111111
1111111111111111111111111
1111111111111111111111111
1110000200011100002000111
1110000200011100002000111
1110000200011100002000111
1110001100011100011000111
1110001100011100011000111
1110001100011100011000111
1110R0110E01110R0110E0111
1110001100011100011000111
1111111111111111111111111
1111111111111111111111111
1111111111111111111111111
level3-3.txt