25
14
Chip Round The Bend
111111WWWWWWWWWWWWWWWWWW1
111111W11111000000000R0W1
111111B1111100000000000W1
111111W1111100000<00000W1
110000w0000000000000000W1
110000w0000000000000000W1
110000w0000000000000000W1
110000w0000000000000000W1
110000W1111111111WWWWWWW1
110000w0000000000W0000011
110000w0000000000W0000011
110000w0000000000D000E011
110000w>000000000W0000011
1111111WWWWWWWWWWW1111111
level1-5.txt