28
16
Pre Damaged
1111111111111111111111111111
11111111WWWWWWWWW11111111111
1RXX0X1XwXXXXXXXwXXXXXXXXXX1
1111(X1Xw0XXXXXXwXXXXXXXXXX1
1XXX0X1Xw0000000w00000000XX1
1XXX0X1XwXwWDWW0w00000000XX1
1XXX0X1Xw0w1E1BWw0XXXX101XX1
1XXX0X1X]ww111WWXXX00X101XX1
1XXX0X1X111XXX1X00000X1[1XX1
1XXX0X111XXwWWW100XX0X101XX1
1XXX0XXXXX0wX1B1X0XX0X101XX1
1XX00X00000wXWW1X0XX0XWDWW11
1XX00000XXXw0D0{00XXwww01W11
1XXXXX00XXX)XW1100XX}XXX1B11
11111111111WWW111111WWWWWW11
1111111111111111111111111111
level8-3.txt