25
14
You Have Got To Be Joking
111WWWWWWWWWWWWWWWWWWWW11
111W111111000001111111B11
111W11111100E001111111W11
111W111111000001111111W11
111W}WW)WWWWDWWWW>WW]WW11
1111011011000001101101111
1111011(110000011<1101111
1111011000000000001101111
1111011111000001111101111
1111{111110000011111[1111
1111000000000000000001111
111111111100R001111111111
1111111111000001111111111
1111111111111111111111111
level5-2.txt