28
16
What
1111111111111111111111111111
1RRRRRRRRRRRRRRRRRRRRRRRRRR1
11R{000000000000000000000(R1
11R00000000000000000000000R1
11R00000000000000000000000R1
11RwwwwwwwwWWDWWWwwwwwwwwwR1
11Rw000000010000100000000wR1
11Rw0000wWW100E0100000000wR1
11Rw0000w1B10000100000000wR1
11Rw0000w1W11111100000000wR1
11Rw0000w0w00000000000000wR1
11Rw0000w0w00000000000000wR1
11Rw0000w0w00000000000000wR1
11R)wwwww0wwwwwwwwwwwwwww}R1
11RRRRRRRRRRRRRRRRRRRRRRRRR1
1111111111111111111111111111