28
16
Just One Chip
1111111111WWWWWWWWWWWWW11111
1XX00XXXXXWX00X000000XW10E01
1R{00XX000w000X0XXXX0XB10001
1XXX0XX00XW000X0XXXX0XWWWDWW
1XXX0XXX0X}X0XX0XXXX0XXXX0XW
1X0000XX0XwX0XXwWWWWwwwwwwWW
1X0000XX0XwX00XwX00XXXXXXXX1
1X0XXXXX0XwwwwwwX00000XXXXX1
1X0XXXXX0X00XXXXX0XX00X00001
1X0XXXX000XXXXXX00XX0XX00001
1X0XXXX000000000000X000000X1
1X0XXXX00XXXXXXX000X00XXX0X1
100XXXXXXXXXXXXXXXXXXXXX0001
1000000000000000000000000001
1XXXXXXXXXXXXXXXXXXXXXXXX001
1111111111111111111111111111
level7-5.txt