25
14
Ready Your Lasers
1111111111111111111111111
1222X222221222122222222R1
122222222212E212222222221
Wwww]ww2221222122222222X1
W22222w2221WDWWwww22www>W
W22222wwwwww22222w22w222W
W2X2222X222222222wwww222W
W22222222222222222222222W
W2<222222222222222222222W
W22222222222222222222222W
WW12X2222222222X2[2X2222W
1B1222222222222222222222W
1WWWWWWWWWWWWWWWWWWWWWWWW
1111111111111111111111111
level8-2.txt