22
12
1111111111111111111111
1100000000000000001111
1100000000000000001111
110R011111111111001111
1111111111111111001111
1100000002000000001111
1100000002000000001111
1122111111111111111111
1100111111111111100011
110000002200000000E011
1100000022000000000011
1111111111111111111111
level1-3.txt