25
14
Even More Hazards
1WWWWWWWWWWWWWWWWWW111111
W>0XXX00000XXX0000W000001
W00X1XXX000XRX0000W00E001
W00XXX1X000X0X0000W000001
W0000XXX0000000000WWWDWWW
W0000000000{0<0000000000W
W00000000000XXX000000000W
WXXX00000000X1X000000000W
WX1X00000000XXX000000000W
WXXX000XXX0000000XXX0000W
W000000X1X0000000X1XXX00W
WWW1000XXX0000000XXX1X00W
11B1000000000000000XXX0}W
11WWWWWWWWWWWWWWWWWWWWWW1
Level2-5.txt