25
14
More Multitasking
1111111111111111111111111
11111111111111111111WWWWW
1000X00000XXXXX00000W000W
10R<X000000000000000D0E0W
1000000000000000000wW0wwW
1000000000X00000000>11B11
1111111111111111111WWWW11
1111111111111111111111111
1000000000000X000000WwwwW
10R(0000000000000000D0E0W
1000000X0000000XX00wW000W
1000000X00000XXXXXX)1WW1W
1111111111111111111WWWB1W
1111111111111111111111WWW