25
14
The Actual Drill
1111111111111111111111111
1000000000000000000000001
1000000000000000000000001
1000XXXXXXXXXXXXXXXXX0001
100X1111111111WWWWWW1X001
100X1XXXXXXXXXW0001W1X001
100X1X000000XXW0E01W1X001
100X1X0XXX0000D0001B1X001
100X1X0XXXXXXXW0001W1X001
100X1wwwWWWWWWW1111W1X001
10<X1w00XXXXXXXXXXXwX0001
10RX1w0000000000000w00001
100X1>0000000000000w00001
11111WWWWWWWWWWWWWWW11111
level4-3.txt