28
16
Do you see what I see
1111111111111111111111111111
1XXXXXXXXXXXXXXXXXXXXXXXXXX1
1XXXXXXXXXXXXXXXXXXXXXXXXXX1
1XXXXXXXXXXXXXXXXXXXXXXXXXX1
1XXXXXXXXXXXXXXXXXXXXXXXXXX1
1XXXXXXXXXXXXXXXXXXXXXXXXXX1
1XXXXXXXXXXXXXXXXXXXXXXXXXX1
1XXXXXXXXXXXXXXXXXXXXXXXXXX1
1XXXXXXXXXXXXXXXXXXXXXXXXXX1
1XXXXXXXXXXXXXXXXXXXXXXXXXX1
1XXXXXXXXXXXXXXXXXXXXXXXXXX1
1XXXXXXXXXXXXXXXXXXXXXXXXXX1
1XXXXXXXXXXXXXXXXXXXXXXXXXX1
1XXXXXXXXXXXXXXXXXXXXXXXXE01
1RXXXXXXXXXXXXXXXXXXXXXXX001
1011111111111111111111111101