22
12
11111111111LLLLLLLLLL1
11LLLL11111L00000001L1
11L11B11111L000R0001L1
11L11LLLLLLL00000001L1
11L00000000000000001L1
11L000000000000<0001L1
11LL0000000000000001L1
111>00000111111LLLLLL1
1LLL00000000000L000111
1L1000000000000D0E0111
1L1000000000000L000111
1LLLLLLLLLLLLLLL111111
level1-5.txt