25
14
Chip Stack
1111111111111111111111111
1WWW111111111111111111111
1B1W111111111111111111111
WW1W111111111111111111111
W11W111111111111111111111
W00wwwwwww]}>)wwwwwwW0001
W0R00000000000000000D0001
W000000000(<[{000000W0E01
W0000000000000000000W0001
WWWWWWWWWWWWWWWWWWWWW1111
1111111111111111111111111
1111111111111111111111111
1111111111111111111111111
1111111111111111111111111
level5-3.txt