28
16
The Great Chip Offensive
1111111111111111111111111111
1000000000000000000000000001
10R000<000000000000000000001
100000[000000000000000000001
111111001111111111111111X001
100001111wwwW00010000001X001
100000011]00D0E010000001X001
100000011W00WwwwWwwww001X001
100X10011W0011111001W001X001
100X10000wwwwWWW100W>001X001
100X10000000011B100W0001X001
100X11111111111WWwwW11110001
1000000000000000000000000001
1000000000000000000000000001
1000000000000000000000000001
1111111111111111111111111111