25
14
Completing The Cycle
1111111111111111111111111
11WWWWWWWWWWWWWWWWW111111
11B111111111111111W111111
WWW111111111111111W111111
W11111111111111111W111111
W00000000000000000w010001
W00000000000000000wwW0001
W0R00000000000000000D0E01
W0000000000000000000W0001
W0000000000000000000W0001
W11111111111111[1111W1111
W1111111111111101111W1111
WWWWWWWWWWWWWWW]WWWWW1111
1111111111111111111111111
level1-4.txt