25
14
Laser Blocks
1111111111111111111111111
111111110R000000000000111
1111111100000000000000111
1111111111111111111000111
1000000000220000000000111
1000000000220000000000111
1000111111111111111111111
1000111111100000000111111
122211111110E000000111111
1000111111100000000111111
1000111111111112222111111
1000000000000000000111111
1000000000000000000111111
1111111111111111111111111
level1-3.txt