25
14
Multicore
WWWWW11111111111111111111
W0E0W11001100X000000X0001
B000W11000000X000000X0R01
W1WDW11000000000110000[01
W0w00110011000001100X0001
W]w0000001100X001100X0001
1111111111111111111111111
WWWWW11111111111111111111
W0E0WXX001100X00110000001
B000WXX000000X00000000R01
W1WDWXX000000X00000000{01
W0w00XX001100000110000001
W}w0000001100000110000001
1111111111111111111111111
level6-2.txt