25
14
The Hazard Shuffle
1111111111111111111111111
1XXXXXXX1XXXXXXX1XXXXXXX1
1X00000X1X00000X1X00000X1
1X0XXX0X1X0XXX0X1X0XXX0X1
1X0X1X0X1X0X1X0X1X0X1X0X1
1X0X1X0X1X0X1X0X1X0X1X0X1
1X0X1X0X1X0X1X0X1X0X1X0X1
1X0X1X0X1X0X1X0X1X0X1X0X1
1X0X1X0X1X0X1X0X1X0X1X0X1
1X0X1X0X1X0X1X0X1X0X1X0X1
1X0X1X0XXX0X1X0XXX0X1X0X1
1XRX1X00000X1X00000X1XEX1
1XXX1XXXXXXX1XXXXXXX1XXX1
1111111111111111111111111
level7-2.txt