25
14
The Actual Drill
1111111111111111111111111
1000000000000000000000001
1000000000000000000000001
1000XXXXXXXXXXXXXXXXX0001
100X11111111WWWWWWWW1X001
100X10000110]010001W1X001
100X10[00XX0wwW0E01W1X001
100X1000000000D0001B1X001
100X1000000000W0001W1X001
100X1wwwWWWWWWW1111W1X001
10<X1w00XXXXXXXXXXXwX0001
10RX1w0000000000000w00001
100X1>0000000000000w00001
11111WWWWWWWWWWWWWWW11111
level4-3.txt