28
16
Absolute Precision
1111111111111111111111111111
1XXXXXXXXXXXXXXXXXXXXXXXXXX1
1XR000000X000X000000000000X1
1XXXXXXX000X0X0XXXXXXXXXX0X1
1X000XXXXXXX0X0X00000000X0X1
1X0X000000000X0X0XXXXXX0X0X1
1X0XXXXXXXXXXX0X0X0000X0X0X1
1X000X000X000X0X0X0EX0X0X0X1
1XXX000X000X0X0X0XXXX0X0X0X1
1XXXXXXXXXXX0X0X000000X0X0X1
1X00000000000X0XXXXXXXX0X0X1
1X0XXXXXXXXXXX0000000000X0X1
1X000X000X000XXXXXXXXXXXX0X1
1X0X000X000X00000000000000X1
1XXXXXXXXXXXXXXXXXXXXXXXXXX1
1111111111111111111111111111
level7-4.txt