25
14
Can You Do Two
1111111111111111111111111
1XXX111XXXX111XXXXXXXXXX1
1000111000011100000000001
1000111000011100000000001
100011100001110000XXX0001
10001110000XXX00001110001
1000111000000000001110001
1000XXX000000000001110001
1000000000000000001110001
1000wwwwwww00000001110001
10(0w00011WWDWWww01110{01
10R0}wwwWW100010)01110R01
1XXXXXXX1B10E01XwX111XXX1
111111111WWWWWWWW11111111
level4-5.txt