28
16
The Great Chip Offensive
1111111111111111111111111111
100000000XXXXXXXXXXXXXXX0001
10R000<000000000000000000001
100000[00XXXXXXXXXXXXXXX0001
111111001111111111111111X0X1
100001111wwwW00010000001X0X1
100000011]00D0E010000001X0X1
100000011W00WwwwWwwww001X0X1
1X0X10011W0011111001W001X0X1
1X0X10000wwwwWWW100W>001X0X1
1X0X10000000011B100WXXX1X0X1
1X0X11111111111WWwwW111100X1
1000XXXXXXXXXXXXX000XXXX0001
1000000000000000000000000001
1000XXXXXXXXXXXXX000XXXX0001
1111111111111111111111111111