28
16
The Great Chip Offensive But Worse
1111111111111111111111111111
1XXXXXXXXXXXXXXXXXXXXXXX00X1
1XR000<0000000000000000000X1
1XXXX0[00XXXXXXXXXXXXXXXX0X1
111111001111111111111111X0X1
1XXXX1111wwwW0001XXXXXX1X0X1
1XXXX0011]00D0E01X0000X1X0X1
100000011W00WwwwWwwww0X1X0X1
100X10011W0X11111001W001X0X1
1X0X10000wwwwWWW1X0W>001X0X1
1X0X1XXXX00XX11B1X0W0001X0X1
1X0X11111111111WWwwW1111X0X1
1X0XXXXXXXXXXXXXX000XXXXX001
1X00000000000000000000000001
1X00XXXXXXXXXXXXXX00XXXXXXX1
1111111111111111111111111111
level8-4.txt