25
14
Two Of Em
1111111111111111111111111
1111111111000001111111111
111111111100E001111111111
1111111111000001111111111
111111WWWWWWDWWWWWW111111
111111W11100000111W111111
111111)00(00000<00>111111
111111W11100000111W111111
111111W11100000111W111111
111111W11100R00111W111111
111111W11100000111W111111
111111WWWWWWW11111W111111
111111111111B11111W111111
111111111111WWWWWWW111111
level2-2.txt