25
14
They Meet
1111111111111111111111111
W>wwwwwWwwww)wwwwWwwwww]W
W00000010000000001000000W
W00000010000000001000000W
W00000000000000000000000W
W00000000000[00000000000W
W00000000000000000000000W
W111000000(000<000000111W
W00000000000000000000000W
W0000001WWWWDWWW11000000W
W0000001W100000W11000000W
W0R00001B100E00W110000R0W
WXXXXXX1W100000W11XXXXXXW
WWWWWWWWW111111WWWWWWWWWW
level4-4.txt