25
14
Task Delegation
11111111WWWWWWWW1WWWWWWW1
10002000W000100w0w00001B1
10002000D0E0100w0w00[01WW
10002000W000100)ww000000W
10001111W111100000000000W
12221111WWWWWWW110001111W
10002000000010w000000000W
10002000000010w000000000W
10002000000010w000000000W
11111111122210w000000000W
10000000200010w00000(000W
10R00000200010]0000000R0W
10000000200010w000000000W
11111111111111WWWWWWWWWWW
level3-4.txt