25
14
Fancy Footwork
1111111111111111111111111
1R000000000000000000000X1
1XXXXXXXXXXXXXXXXXXXXX0X1
11111111111111111111110X1
1XXXXXXXXXX000000X1X000X1
10000000000011110X1X01111
10X11111111110000X1X000X1
100X1000000X10XXXX1XXX0X1
1X0X10XXXX0X10111111100X1
1X0X10X1XX0X10000XXX000X1
1X0X10XXXX0X1XXX0X1X0XXX1
1X00X0XXXXEX1X1X0XXX0X1X1
1XX000X1XXXX1XXX00000XXX1
1111111111111111111111111
level7-3.txt