28
16
Victory Lap
111111111WWWWWWWWWW111111111
100000000W11111111W000000001
100R00000W11111111W00000R001
100000000W11111111W000000001
100000000W1[1111[1W000000001
1000000WWW11111111WWW0000001
100000WW111WWWWWW111WW000001
100000W11111111111111W000001
100000W1111121]1]1111W000001
100000W11W100X0001W11W000001
100000W11W1XX0X0X1W11W000001
100000W11W10000X01W11W000001
100000WWWW11111111WWWW000001
100E000W11111WW11111W000E001
1000000W11111WW11111W0000001
11111111111111111111W0111111