22
12
111111LLLLLLLLL1LLLLLL
100000L0000000L}L0000L
100000D00000000000000L
100E00L00000000000000L
100000L00000000000000L
LLLLLLL11000000000000L
L0000002000{000000000L
L00000020000000000000L
L00011111111111111111L
L0000002000000000001LL
L0000002000000000R01B1
LLLLLLLLLLLLLLLLLLLLL1