22
12
1111111111111111111111
1111111111111111111111
LLLLLLLLLLLLLLLLLL1111
L1111111111111111L1111
L0000000000000000L0001
L0000000000000000L0001
L0R00000000000000D0E01
L0000000000000000L0001
LL11111111111[111L1111
1B111111111110111L1111
1LLLLLLLLLLLL]LLLL1111
1111111111111111111111
level1-4.txt