25
14
Multitasking
1111111111111111111111111
1111XXEXX1111111X0E0X1111
1111X00XX1111111X000X1111
1111X00XX1111111XX0XX1111
1111XX00X1111111X000X1111
1111XX0XX1111111X000X1111
1111X000X1111111X000X1111
1111X000X1111111X0XXX1111
1111X000X1111111X000X1111
1111XXX0X1111111X000X1111
1111X000X1111111X000X1111
1111X000X1111111X0XXX1111
1111X0R0X1111111X0R0X1111
1111111111111111111111111
level3-5.txt