25
14
In The Swing Of Things
WWWWWWW11111111111WWWWWWW
W00000>00000000000}00000W
W00000w00000000000w00000W
W00000w00000000000w00000W
W00{00w00000000000w00<00W
W00000wwwWWWDWWWwww00000W
W00000000100000100000000W
W00000000100E00100000000W
W00000000100000100000000W
WwwwwwwwwWWWW11100000000W
100000000111B11100000000W
100000000111WWWWwwwwwwwwW
100000000000R000000000001
1111111111111111111111111
level3-2.txt