28
16
Many Robots
1111111111111111111111111111
1R0000000000011RXXX000000001
100000000XXE0110000000000E01
1XX00XXX00000110000000000001
10000X00000001100000000X0001
1000000000XX0110X000000X0001
10000000000001100000X0000001
1111111111111111111111111111
1111111111111111111111111111
1R000XX00000011R000000X00001
10000XX0000E0110000000X00E01
10000000X00X011XXX0000000001
10000000000X0110000000000001
1000X000000X01100X000X000001
10000000000X011000000X000001
1111111111111111111111111111
level6-4.txt