28
16
Many Robots Many Chips
1111111111111111111111111111
1R00X0000000011R000X0000X001
10{0X00000000110(00X00000001
1X000X000XwwwW10X0X0X000wwwW
1X00X0X011W0XW1X000X0011W0XW
1X0000001ED00B1X0000001ED0XB
1X00XX0011W}XW1X00000011W)0W
11111111111WWW11111111111WWW
1111111111111111111111111111
1R0000000X00011R0000000XX001
10[00X0000000110<00000000001
100000X000wwwW1000X0000XwwwW
100000X011W0XW1X000X0011W00W
1X0000001ED00B100000001ED00B
1XXX000011W]0W1XXXXX0011W>0W
11111111111WWW11111111111WWW
level6-5.txt