22
12
Precision Scheduled Computing
1111111111111WWW1WWWW1
1100000000011B1Ww)00>W
1101111101011W1100000W
11R0(<{[01000w0000000W
1101111101111w1100000W
1100000101111wWWW}00]W
11111101011110111W10W1
11111100000000111WWDW1
1111110111111011110001
1111110000000011110E01
1111111111111111110001
1111111111111111111111