28
16
Four Corners
1WWWWWWWWWWW1111WWWWWWWWWWW1
1}000100000W0000W001001002]1
1W100100000W0E00W001001001W1
1W100100100W0000W002001001W1
1W100100100WWWDWW002001001W1
1W100000100000000001002001W1
1W1000001000[0(00001002001W1
1W11111111100<0{0111111111W1
1W111111111000R00111110000W1
1w00X00X00X000000000000000w1
1w00000X00X001111111100000w1
1w00000X000001100000111100w1
1w00X000000001100000000000w1
1w00X00000XwWW110011111111W1
1>00X00X00Xw1B110000000000)1
1WWWWWWWWWWW1WWWWWWWWWWWWWW1
level5-5.txt