25
14
Round The Bend
1111111111111111111111111
1111111111111111000000001
10000000000000110E0000001
1000000000000011000000001
1000000000000011111110001
1000001111000011111110001
1000001111000011111110001
1000001111000011111110001
1000001111000011111110001
1000001111000011111110001
1000001111000000000000001
100R001111000000000000001
1000001111000000000000001
1111111111111111111111111
level1-2.txt