25
14
Put it all together
1111111111111111111111111
11000000Wwwwwwwww}wwWW111
1100E000W000000000001W111
11000000D000000000001W111
11111111W222220000001W111
11000000w000020000001W111
11000000w000020000001B111
11000000w000020000001W111
11000011W111111111111W111
11222211WWWWWWWWWWWWWW111
1100000000000000000000011
1100000000000000000{0R011
1100000000000000000000011
1111111111111111111111111