25
14
You Know The Drill
1111111111111111111111111
10000000000000000000000X1
10R0[000000000000000000X1
10000000000000000000000X1
11111111111111111111000X1
1X000022200000000000000X1
1X000022200000000000000X1
1X000022200000000000000X1
1X0001111111111111WWWWWWW
1X0000000110000001B11000W
1X0000000XX0000001W]W0E0W
1X000XX0000000000000W000W
1X000110000000000000D000W
11111111111111111111WWWWW
level4-2.txt