25
14
Chip Push Chip
1111WWWWWWWWWWWWWWWWWWWW1
1111W111100000000000000]1
1111W111100000000000000w1
1111B111100000000000000w1
WWWWW111100000000000000w1
W111111110000000000WWWWW1
W000000010000000000W00001
W0R00000{[000000000D00E01
W000000010000000000W00001
W111111110000000000WWWWW1
W1111111100000000000000w1
W1111111100000000000000w1
W1111111100000000000000}1
WWWWWWWWWWWWWWWWWWWWWWWW1
level2-3.txt