25
14
But Suddenly A Hazard
1111111111111111111111111
1X00000000111111111111111
1X00000000111WWWWWWWWWWWW
1X00000(00111B1111111111W
1X01100000111W1111111111W
1X01100000111W1111111111W
1X01100000111Wwww)wwW000W
1X011000001111000000W0E0W
10011000001111000000W000W
10X11000000000000000WWDWW
10X1100000000000000000001
10X1100000000000000000001
1RX11XXXXXXXXXXXXXXXXXXX1
1111111111111111111111111
level2-4.txt