28
16
Triple Trouble
111111WWWWWWWWWW1WWWWW111111
111111W00000000W1W000W111111
111111W000R0000W0D0E0W111111
111111W00000000W0W000W111111
1XXXXXW00000000D0W111WXXXXX1
100000}00000000W1W111W000001
100000W00000000W1W111W000001
100000W00000000w0w000W000001
100000W00000000w0w000)000001
100000WW1000000w0wWW1W000001
1000001B1000000w001B1W000001
1000011WW]WWWWWW111WWW100001
1000000010000000000100000001
100000{0100000000[010(000001
100000001XXX0000000100000001
1111111111111111111111111111