28
16
Many Chips and Many Robots
1111111111111111111111111111
1000000000000110000000000001
10R0000000w>wWW0R{0000000001
100<000000w001W0000000000001
1000000000W111W0000000000001
1000000000D000Ww}wwwwwwwwwwW
WwwwwwwwwwW0E01000000000000W
W11111111110001111111111111W
W1WWWWWWWWWWW11111111111111W
Ww)000000011B11000000000000W
10R000000011WW10R0000000000W
10(0000000000W10[0000000000W
1000000000000W1000000000000W
1000000000000WWwwwwwwwwww]wW
1000000000000110000000000001
1111111111111111111111111111
level5-4.txt