36
21
Yes the levels can get bigger
111111111111WWWWWW111111111111111111
1R1110011111W1100D00XXXXXXXXXXXX00X1
10<000010000w0000W10[0000000000000X1
100000010011W1000W1XXXXXXXXXXXXXX0X1
111110011011W1101W11111111111111X0X1
100000011011B1101W100000000]WWW1X0X1
100000011011W1101W100000000w11B1X0X1
100111110001W1101W1X0111111W11WWwwX1
100000000001WWW>WW1X0000000w00000wwW
1111111110011111111X0000000w0000000W
111111111111111111111111111WWWWWWWDW
1111WW)WWW}WWW100WW)22X2222222X22221
1111W10111011B100W1W22X2222222X22221
1111W1(111{11W100B1W22X222X222X22221
1000W00000000w00wW1W22X222X222X22221
10E0D00000000w00w11W22X222X222X22221
1000W00000000w00w11W22X222X222X22221
1111W111<111[W10w11W22X222X222X22221
1111W11101110W10w1WW222222X222222(21
1111WWWW>WWW]W10w0D2222222X222222221
1111111111111111WWW11111111111111111
level8-5.txt