25
14
Can you do it two two
1111111111111111111111111
1XXX1111111111XXXXXXXXXX1
1000111111111100000000001
1000111111111100000000001
100011111111110000XXX0001
1000111XXXXXXX00001110001
1000111X00000000001110001
1000XXXX00000000001110001
1000000000000000001110001
1000wwwwwww00000001110001
10(0w00011WWDWWww01110{01
10R0}wwwWW100010)01110R01
1XXXXXXX1B10E01XwX111XXX1
111111111WWWWWWWW11111111
level6-3.txt