22
12
Precision Scheduled Computing
111111111111WWWWWWWWW1
100000000001B1000000w1
100000000001WWw00000w1
10111111110111]00000}W
10R{[000000111w000000W
10111111110111WWwWWDWW
1000000001011111010001
1111111100000000010001
1111111101111111010001
1111111100000000010E01
1111111111111111110001
1111111111111111111111
Level2-5.txt