22
12
LLLLL11111111111111111
LR00L)L001000000000001
L00000L001200000000001
L0000(LLLL2200[000{001
L00000000L200000000001
L00000000D000000000001
L00000000L000000000001
L22222222L11LL]LLDL}LL
L00000000L00L00000000L
LL1000000L00L000E001LL
1B1000000L00L0000001B1
1LLLLLLLLL11LLLLLLLLL1